xpms/stone.xpm
xpms/cobblestone.xpm
xpms/stone_brick.xpm
xpms/mossy_stone_brick.xpm
190,190,190
100,100,100
11111111111111
11111111000001
11111111000001
11111100000001
11111100010001
11111100000001
11111110000111
1111111011111111
1111111010001110
11111110101011
11111110100011
100000W0000001
11111111111111