stone.xpm
cobblestone.xpm
stone_brick.xpm
mossy_stone_brick.xpm
190,190,190
100,100,100
11111111111111
11111111000001
11111111000001
11111100000001
11111100010001
11111100000001
11111110000111
11111110111111
1111111010001111
11111110101011
11111110100011
1W000000000001
11111111111111
