111111111
1CCCCCCC1
1C00000C1
1C00000C1
1C00000C1
1C00000C1
1C0EP00C1
1CCCCCCC1
111111111