11111111111
100000CE101
11111111111
