11111111111111111111
100000000E0000100001
10000000000000100001
10000000000C00111001
100000000P0000101001
11111111111111111111