11111111111
10P100CE101
11111111111
