11111111111111111111111111111111111
10000000000000000000000000000000001
100000000E0000100000000000000000001
10000000000000100000000000000000001
10000000000000111000000000000000001
100000000P0000101000000000000C00001
10000000000000111000000000000000001
10000000000000100000000000000000001
10000000000000000000000000000000001
11111111111111111111111111111111111