11111111111
10P000CE100
11111111111
