11111111111
10P0000E101
11111111111
