11111111111
10P000C0101
11111111111
