11111111111111111111
100000000E0000100001
11111100110000100001
11111100110000100001
11111100000C00100001
11111100000000100001
10001010000000000001
10001110000C00111111
100011101P0110101001
11111111111111111111