11111111111111111111
100000000E0000101101
11111100110000101101
10111111110000100011
11111111000C01110011
11111100000000100001
10001010000000000001
10001110000C00111111
100010101P0110101001
11111111111111111111