1111111111111111111111111111
1101110111000000000000000011
1000000010101000000000000001
1111110000011100000000000001
1101101000111110000000000001
1111111100011100000000000001
1010111000001000000000000001
111101000110111000C000000001
1010000101111010000000000001
1011101101010100000000000001
1001111001000100000000000001
10010010001110000000000C0001
1001111101101100000000000001
1001010101010100000000000001
1001111101101100000000000001
1001010100111000000000000001
1101111100000000P0C000000E11
1111111111111111111111111111