1111111111111111111111111111
1000000001000000000000000001
1000000001000000000000010001
1000011101000111110011111001
1000000111101110111010010001
1000011101000100010110010001
1000011101000001111110010001
1011011101000000000000010001
1001110000000000000000010001
1011010011000000000000010001
1000000011110000000000010C01
100000001001000000000000PCE1
1111111111111111111111111111