111111111111111111111
1CCCCCCCCCCCCCCCCCCC1
1C00000000000000000C1
1C00000000000000000C1
1C00000000E00000000C1
1C00000000000000000C1
1C00000000P00000000C1
1CCCCCCCCCCCCCCCCCCC1
111111111111111111111
