1111111111111111111111111111
1101111111111111111111111111
1ECCCCCCCCCCCCCCCCCCCCCCCCC1
11111111111111111111111111C1
1CCCCCCCCCCCCCCCCCCCCCCCCCC1
1C11111111111111111111111111
1CCCCCCCCCCCCCCCCCCCCCCCCCC1
11111111111111111111111111C1
1CCCCCCCCCCCCCCCCCCCCCCCCCC1
1C11111111111111111111111111
1CCCCCCCCCCCCCCCCCCCCCCCCCC1
11111111111111111111111111C1
1CCCCCCCCCCCCCCCCCCCCCCCCCC1
1C11111111111111111111111111
1CCCCCCCCCCCCCCCCCCCCCCCCCC1
11111111111111111111111111C1
1PCCCCCCCCCCCCCCCCCCCCCCCCC1
1111111111111111111111111111