11111111111111111111
1C0P0000000000000CE1
11111111111111111111